11111111111111111111111111111
10000000000000000000000000001
10111111011111111111011111101
10000001000000000000010000001
10111101011111011111010111101
10000101000000000000010100001
10110101011111011111010101101
10000100000000000000000100001
10110101010111211101010101101
100000010101d333d101010101101
101101010101d333d101010000001
10110101010111111101010101101
10000100000000000000000100001
10110101011111011111010101101
10000101000000000000010100001
10111101011111011111010111101
10000001000000000000010000001
10111111011111111111011111101
10000000000000p00000000000001
11111111111111111111111111111

0 loptica
1 zid
2 vrata
p pacman
d duh
3 prazno
